행 정	국방정책 , 군사전략 , 체계분석, 평가 , 제도, 계획, 연구업무 · 일반행정, 정훈, 심리업무 · 법제, 송무, 행정소송업무 · 원가회계 , 내.외자관리 , 세입.세출결산, 재정금융 조사분석,계산증명 , 급여업무, 물품청구, 획득 , 관리, 분배, 결산, 구매판단, 계약 등 군수조달 계획 업무 · 국유재산, 부동산 관리유지 . 처분에 관한 업무
사 서	도서의 수집, 선택, 분류, 목록작성, 보관, 열람에 관한 업무
군 수	군수품의 소요/조달, 보급/재고관리, 정비계획, 장비관리, 물자수불(청구, 불출)업무, 물품의 생산·공정·품질·안전관리·자원활용 등 작업계획, 생산시설 유지·생상품 처리 업무
군사정보	주변국 및 대북 군사정보 수집, 생산관리, 부대전파 및 군사보안 업무
기술정보	외국정보 및 산업, 경제, 과학기술 정보의 수집, 생산관리 보안 업무 · 정보용 장비, 기기 등에 의한 정보수집 업무
수 사	범죄수사, 비위조사, 범죄예방, 계몽활동 등에 관한 업무
시 설	토 목	토목공사에 관한 계획, 설계, 시공 및 감독 업무
건 축	건축공사에 관한 계획, 설계, 시공 및 감독 업무
시 설	건물의 기능발휘를 위한 전반적인 시설물 안전관리·유지보수 및 시설공사 감독업무
환 경	대기수질, 폐기물, 오염검사 및 소음진동 측정, 시설물 시공 평가에 관한 업무
정보통신	전 기	전기설계, 전도기, 발전기, 전원부하, 송배전 및 변전, 전기에너지, 압축기구, 전기기기 , 전기시설 등 전기 전반에 관한 정비, 수리 업무
전 자	전자장비 및 주변장비 분해, 조립, 재생, 정비, 수리 업무 · 전탐, 항법장비 조작, 정비, 수리 업무 · 전자현상에 대한 과학 및 응용기술 등 전자 전반에 관한 정비, 수리 업무 · 각종 기계, 계기 등의 교정, 정비, 수리 업무
통 신	유·무선 통신장비, 기기 조작운용 등 통신 전반에 관한 정비, 수리 업무
전 산	소프트웨어 개발, 프로그램 작성, 시스템 구조설계, 전산통신 분석, 체계개발 업무
지 도	각종 지도 측량, 편집, 지도제작 업무
영 상	각종 사진 촬영, 현상, 인화, 확대편집, 필름보관 관리 업무 · 각종 사진기, 영사기 조작, 관리 업무 · 항공사진 제작 분석, 판독 및 항고표적 분석, 자료생산 업무 · 항공사진 인화, 확대, 현상, 필름보관 관리 업무
공 업	일반기계	각종 기계 및 장비 부속품의 설계업무 · 각종 공작기계·공구 등을 조작하여 금속류의 가공·제작· 조립 업무 · 각종 장비의 기골·외피의 금속부분 제작, 정비, 수리업무
금 속	금형제작, 주물생산, 금속 및 비금속 성분의 용해로 운용업무 · 금속의 탄소밀도 변화처리 · 금속 표면의 산화 및 마모 방지를 위한 각종 도금업무
용 접	전기, 단조저항, 가수, 특수용접 등 각종 용접업무
물리분석	물리학적 감식, 검출 업무 · 방사선 및 전자파 등을 이용 금속의 결함 탐지, 검사 업무
화학분석	각종 금속, 비금속 재료에 대한 화학적 성분 검사 업무 · 각종 연료 분광, 분석 검사 업무 · 화학물질의 성질과 상호간 화학적 반응 개발 업무 · 생체 구성분 결정, 생체 성분간 화학적 변화 및 생화학 연구 개발 업무
유도무기	포 및 유도무기, 사격통제장치, 각종 축적기계 장비의 정비, 수리 업무 · 각종 광학장비 정비, 수리 업무 · 함정, 항공기 탑재 무장장비 및 관련 장비 재생, 설치, 정비, 수리 업무
총 포	유도장치가 있는 무기를 제외한 각종 총포, 화포, 특수무기 생산, 제작, 정비, 수리 업무 · 각종 화학병기 및 장비의 제작, 관리, 정비 ,수리 업무
탄 약	탄약의 제조, 분해, 품질검사, 성능검사, 저장·안전관리, 정비수리, 재고통제, 적송 업무 · 비파괴시험을 통한 탄약의 결함 검출 및 판독 업무 · 각종 유도탄, 수중탄 발사장치 및 관계되는 장비 분해, 조립, 설치, 정비, 수리 업무
전 차	전차·장갑차량의 부품제작, 조립, 정비, 수리 업무 · 내·외연기관 및 엔진부품의 생산, 조립, 정비, 수리 업무
차 량	건설장비(중장비·경장비·컴프레셔) 및 연계된 장비 정비·수리 및 관리 업무 · 육상용 차량 분해, 조립, 부품대체, 정비, 수리 업무 · 내·외연기관 및 엔진부품의 생산, 조립, 정비, 수리 업무
인 쇄	인쇄기기 조작, 운용, 정비, 수리업무 · 편집, 교정, 교열, 화공 등에 관한 업무 · 원판, 조판, 연마, 제판, 제본 등에 관한 업무
함 정	선 체	선체골격, 늑골 접합, 의장, 설계, 제작 및 정비, 수리 업무 · 선목의 골격·늑골 접합, 선체의 목재부분 의장, 설계, 제작, 정비, 수리 업무 · 대·소형 선박용 보일러의 제작·설치·실험, 각종 파이프의 가공제작·정비·수리 업무
선 거	입거 함정의 선저(수면하 선체), 장비이동 및 관계되는 업무
항 해	함정 입·출거시 도선 및 기타 항해 업무
함정기관	주 추진기관, 선박용 발전기, 원동기 및 관련되는 보조장비 정비, 수리 업무
잠 수	수면하 선체 보수, 수로 장애물 제거, 수중폭파, 용접, 절단, 탐색에 관한 업무
항 공	기 체	항공기 기체, 제작, 분해, 조립, 정비, 수리업무
항공기관	항공기 엔진 및 관련되는 보조장비 분해, 조립, 제작, 정비, 수리 업무
항공보기	보조기기 및 관련된 보조장비 분해, 조립, 제작, 정비, 수리 업무
항공지원	항공기 내·외부 도장 및 각종 특수도장 업무 · 지원되는 소방차, 급유차, 견인차, 특수차량, 운전, 정비, 수리, 검사 업무
기 상	기 상	각종 기상장비, 기기 및 관계된 장비 조작·운용관리 업무
기상예보	기상관측, 예보, 분석, 통계관리 등에 관한 업무
보 건	약 무	각종 의약품 획득, 투약, 분배, 저장관리 업무
병 리	병리 임상검사, 원인분석, 임상관찰, 환자치료에 관계되는 자료관리 업무
방사선	방사선 이용 질병진단, 환부투시, 촬영, 치료 및 자료관리 업무
치 무	각종 의치 설계·제작업무, 치아 및 구강질환의 예방과 위생에 관한 업무(치석제거, 불소도포 등)
재활치료	질병 및 신체장애를 예방하기 위해 전기, 광선, 물, 냉온열 등을 이용한 치료적 마사지와 운동 치료를 포함한 치료 업무
의무기록	진료전반에 대한 통계와 의무기록의 분석 및 미비기록 관리, 의무기록 재검토, 질병색인, 수술색인 등의 색인 업무
의 공	의지, 의안 설계, 제작업무 · 각종 의료장비, 기기 제작 및 정비, 수리업무
영양관리	식품저장, 가공, 영양분석, 식단작성 업무
관 리
운 영
(17)	전산운영	워드프로세서에 관한 입·출력 업무
발간운영	문서발간, 인쇄물 관리 업무
사무운영	행정보조 업무
병참운영	장구류, 병참물자 점검, 수리, 보존관리, 가공 업무
물자 및 물품저장, 관리, 하역, 적재, 수송에 관한 업무
탄약운영	탄약분야 정비보조 · 재/퇴적 · 치환 · 표기 · 안전관리 등 업무
조경운영	각종 원예, 수목관리, 조경조성 등에 관한 업무
사육운영	군견, 군마 등 양축동물의 축사시설 관리, 사료, 훈련에 관한 업무
이·미용운영	이·미용 기구를 이용, 이발, 면도 및 이·미용실 관리 업무
조리운영	조리, 주·부식 저장, 취사기구 관리업무
보건운영	세탁, 청소 및 대기, 수질, 폐기물, 오염검사, 간호보조, 진료지원 업무
시설운영	각종 시설물관리, 미장, 보수 등에 관한 업무
상 하수도, 냉난방, 선박 등에 각종 배관 및 위생설비 업무
통신운영	유·무선망보수, 선로측정, 통신기기수리 업무
전화기, 교환기 고장수리, 예방정비 업무
목공운영	각종 건물 목재부분의 보수, 비품, 집기의 제작, 관리유지 업무
교환운영	전화기 조작, 전화연결, 주파수의 검사에 관한 업무
운전운영	육상에서 운영되는 각종 차량 운전 및 장비 관리, 유지 업무
기계운영	각종 기계, 차량, 총포, 탄약 등에 관한 정비/지원 업무
전기운영	전기기기 조작, 운영, 정비, 수리, 송·배전 및 변전, 전기가설에 관한 업무
전류계, 전압계 등 계기에 관계되는 업무